***********
*.........*
*.*.***.*.*
*.*.*...*.*
*.*.*.*.*.*
*.*.*.*.*.*
*.*.*.*.*.*
*.*.*...*.*
*.*.***.*.*
*.........*
***********
