************
*..........*
*.*.*.*.*..*
*..........*
*.*.*.*.*..*
*..........*
*.*.*.*.*..*
*..........*
************
